Clipping
0 0 0 0 0 0 0 0 0 0 0 0 0 0 0 0 0 0 0 0 0 0 0 0 0 0 0 0 0 0 
0 0 0 0 0 0 0 0 0 0 0 0 0 0 0 0 0 0 0 0 0 0 0 0 0 0 0 0 0 0 
0 0 0 0 0 0 0 0 0 0 0 0 0 0 0 0 0 0 0 0 0 0 0 0 0 0 0 0 0 0 
0 0 0 0 0 0 0 0 0 0 0 0 0 0 0 0 0 0 0 0 0 0 0 0 0 0 0 0 0 0 
0 0 0 0 0 0 0 0 0 0 0 0 0 0 0 0 0 0 0 0 0 0 0 0 0 0 0 0 0 0 
0 0 0 0 0 0 0 0 0 0 0 0 0 0 0 0 0 0 0 0 0 0 0 0 0 0 0 0 0 0 
0 0 0 0 0 0 0 0 0 0 0 0 0 0 0 0 0 0 0 0 0 0 0 0 0 0 0 0 0 0 
0 0 0 0 0 0 0 0 0 0 0 0 0 0 0 0 0 0 0 0 0 0 0 0 0 0 0 0 0 0 
0 0 0 0 0 0 0 0 0 0 0 0 0 0 0 0 0 0 0 0 0 0 0 0 0 0 0 0 0 0 
0 0 0 0 0 0 0 0 0 0 0 0 0 0 0 0 0 0 0 0 0 0 0 0 0 0 0 0 0 0 
0 0 0 0 0 0 0 0 0 0 0 0 0 0 0 0 0 0 0 0 0 0 0 0 0 0 0 0 0 0 
0 0 0 0 0 0 0 0 0 0 0 0 0 0 0 0 0 0 0 0 0 0 0 0 0 0 0 0 0 0 
0 0 0 0 0 0 0 0 0 0 0 0 0 0 0 0 0 0 0 0 0 0 0 0 0 0 0 0 0 0 
0 0 0 0 0 0 0 0 0 0 0 0 0 0 0 0 0 0 0 0 0 0 0 0 0 0 0 0 0 0 
0 0 0 0 0 0 0 0 0 0 0 0 0 0 0 0 0 0 0 0 0 0 0 0 0 0 0 0 0 0 
0 0 0 0 0 0 0 0 0 0 0 0 0 0 0 0 0 0 0 0 0 0 0 0 0 0 0 0 0 0 
0 0 0 0 0 0 0 0 0 0 0 0 0 0 0 0 0 0 0 0 0 0 0 0 0 0 0 0 0 0 
0 0 0 0 0 0 0 0 0 0 0 0 0 0 0 0 0 0 0 0 0 0 0 0 0 0 0 0 0 0 
0 0 0 0 0 0 0 0 0 0 0 0 0 0 0 0 0 0 0 0 0 0 0 0 0 0 0 0 0 0 
0 0 0 0 0 0 0 0 0 0 0 0 0 0 0 0 0 0 0 0 0 0 0 0 0 0 0 0 0 0 
0 0 0 0 0 0 0 0 0 0 0 0 0 0 0 0 0 0 0 0 0 0 0 0 0 0 0 0 0 0 
0 0 0 0 0 0 0 0 0 0 0 0 0 0 0 0 0 0 0 0 0 0 0 0 0 0 0 0 0 0 
0 0 0 0 0 0 0 0 0 0 0 0 0 0 0 0 0 0 0 0 0 0 0 0 0 0 0 0 0 0 
0 0 0 0 0 0 0 0 0 0 0 0 0 0 0 0 0 0 0 0 0 0 0 0 0 0 0 0 0 0 
0 0 0 0 0 0 0 0 0 0 0 0 0 0 0 0 0 0 0 0 0 0 0 0 0 0 0 0 0 0 
0 0 0 0 0 0 0 0 0 0 0 0 0 0 0 0 0 0 0 0 0 0 0 0 0 0 0 0 0 0 
0 0 0 0 0 0 0 0 0 0 0 0 0 0 0 0 0 0 0 0 0 0 0 0 0 0 0 0 0 0 
0 0 0 0 0 0 0 0 0 0 0 0 0 0 0 0 0 0 0 0 0 0 0 0 0 0 0 0 0 0 
0 0 0 0 0 0 0 0 0 0 0 0 0 0 0 0 0 0 0 0 0 0 0 0 0 0 0 0 0 0 
0 0 0 0 0 0 0 0 0 0 0 0 0 0 0 0 0 0 0 0 0 0 0 0 0 0 0 0 0 0 

sprites/castle.png
450 450 450 450 450 450 450 450 450 450 450 450 450 450 450 450 450 450 450 450 450 450 450 450 0 0 0 0 0 0 
450 450 450 450 450 450 636 636 636 636 636 636 636 636 636 636 636 636 636 636 636 450 450 450 450 0 0 0 0 0 
450 450 450 450 450 450 387 387 387 387 387 387 387 387 387 387 387 387 387 387 387 387 387 450 450 450 450 0 0 0 
0 450 450 450 450 450 387 387 387 387 387 387 387 387 387 387 387 387 387 387 387 387 387 387 387 450 450 450 0 0 
0 387 387 387 387 387 418 418 418 418 418 418 418 418 418 418 418 418 418 418 418 418 387 387 387 387 387 450 450 450 
0 387 387 387 387 387 434 434 434 434 434 434 434 434 434 434 434 434 427 428 434 434 434 434 387 387 387 387 387 387 
0 387 387 387 387 387 387 450 450 450 450 450 434 434 434 450 450 450 427 428 450 450 450 450 450 450 387 387 387 450 
0 387 387 387 387 387 387 466 466 636 636 636 636 636 636 636 466 466 427 428 450 450 450 450 450 450 450 450 450 450 
0 387 387 387 387 387 387 387 387 387 387 387 387 387 387 387 387 387 395 396 389 389 389 389 389 389 389 389 389 389 
0 387 387 387 387 387 387 387 387 387 387 387 387 387 387 387 387 387 443 444 389 389 389 389 389 389 389 389 389 389 
0 387 387 387 387 387 387 387 387 387 387 387 387 387 387 387 387 387 459 460 389 389 389 389 389 389 389 389 389 389 
0 387 387 387 387 387 387 387 387 387 387 387 387 387 387 387 387 387 475 476 389 389 389 389 389 389 389 389 389 389 
0 387 387 387 387 387 387 387 387 387 387 387 387 387 387 387 387 387 387 389 389 389 389 389 389 389 390 389 389 389 
0 387 387 387 387 387 387 387 387 387 387 387 387 387 387 387 387 387 387 771 389 389 389 389 389 389 389 389 389 389 
0 387 387 387 387 387 387 387 387 387 387 387 387 387 387 387 387 387 387 0 389 389 389 389 389 389 389 389 389 389 
0 387 387 387 387 387 387 387 387 387 387 387 387 387 387 387 387 387 387 0 389 389 389 389 389 389 389 389 389 389 
0 387 387 387 387 387 387 387 387 387 387 387 387 387 387 387 387 387 387 0 389 389 389 389 389 389 389 389 389 389 
0 387 387 387 387 387 387 387 387 387 387 387 387 387 387 387 387 387 387 0 389 389 389 389 389 389 389 389 389 389 
0 387 387 387 387 387 387 387 387 387 387 387 387 387 387 387 387 387 387 0 389 389 389 389 389 389 389 389 389 389 
0 387 387 387 387 387 387 387 387 387 387 387 387 387 387 387 387 387 387 0 389 389 389 389 389 389 389 389 389 389 
0 387 387 387 387 387 387 387 387 387 387 387 387 387 387 387 387 387 387 390 389 389 389 389 389 389 389 389 389 389 
0 387 387 387 387 387 387 387 387 387 387 387 387 387 387 387 387 387 387 0 389 389 389 389 389 389 389 389 389 389 
0 387 387 387 387 387 387 387 387 387 387 387 387 387 387 387 387 387 387 389 389 389 389 389 389 389 389 389 389 389 
0 0 0 0 0 0 0 0 0 0 0 0 0 0 0 0 0 0 0 0 389 389 389 389 389 389 389 389 389 389 
0 0 0 0 0 0 0 0 0 0 0 0 0 0 0 0 0 0 0 0 389 389 389 389 389 390 389 389 389 389 
0 0 0 0 0 0 0 0 0 0 0 0 0 0 0 0 0 0 0 389 389 0 389 389 0 0 0 389 389 389 
0 0 0 0 0 0 0 0 0 0 0 0 0 0 0 0 0 0 0 389 389 389 0 389 0 0 0 389 389 0 
0 0 0 0 0 0 0 0 0 0 0 0 0 0 0 0 0 0 0 0 0 0 0 389 389 389 389 389 0 0 
1 1 1 1 1 1 1 1 1 1 1 1 1 1 1 1 1 1 1 1 1 1 1 1 1 1 1 1 1 1 
1 1 1 1 1 1 1 1 1 1 1 1 1 1 1 1 1 1 1 1 1 1 1 1 1 1 1 1 1 1 

sprites/castle.png
419 419 419 419 419 419 419 419 419 419 419 419 419 419 419 419 419 419 419 419 419 704 386 386 386 386 386 386 386 386 
0 0 0 0 0 0 0 0 0 0 0 0 0 0 0 0 0 0 0 0 0 720 703 704 386 386 386 386 386 386 
0 0 0 0 0 0 0 0 0 0 0 0 0 0 0 0 0 0 0 0 0 0 0 720 703 704 386 386 386 386 
0 0 0 0 0 0 0 0 0 0 0 0 0 0 0 0 0 0 0 0 0 0 0 0 0 720 703 704 386 386 
0 0 0 0 0 0 0 0 0 0 0 0 0 0 0 0 0 0 0 0 0 0 0 0 0 0 0 720 703 704 
0 0 0 0 0 0 0 0 0 0 0 0 0 0 0 0 0 0 0 0 0 0 0 0 0 0 0 0 0 720 
0 0 0 0 0 0 0 0 0 0 0 0 0 0 0 0 0 0 0 0 0 0 0 0 0 0 0 0 0 0 
0 0 0 0 0 0 0 0 0 0 0 0 0 0 0 0 0 0 0 0 0 0 0 0 0 0 0 0 0 0 
0 0 0 0 0 0 0 0 0 0 0 0 0 0 0 0 0 0 0 0 0 0 0 0 0 0 0 0 0 0 
0 0 0 0 0 0 0 0 0 0 0 0 0 0 0 0 0 0 0 0 0 0 0 0 0 0 0 0 0 0 
0 0 0 0 0 0 0 0 0 0 0 0 0 0 0 0 0 0 0 0 0 0 0 0 0 0 0 0 0 0 
0 0 0 0 0 0 0 0 0 0 0 0 0 0 0 0 0 0 0 0 0 0 0 0 0 0 0 0 0 0 
0 0 0 0 0 0 0 0 0 0 0 0 0 0 0 0 0 0 0 0 0 0 0 0 0 0 0 0 0 0 
0 0 0 0 0 0 0 0 0 0 0 0 0 0 0 0 0 0 0 0 0 0 0 0 0 0 0 0 0 0 
0 0 0 0 0 0 0 0 0 0 0 0 0 0 0 0 0 0 0 0 0 0 0 0 0 0 0 0 0 0 
0 0 0 0 0 0 0 0 0 0 684 685 685 686 0 0 0 0 0 0 0 0 0 0 0 0 0 0 0 0 
0 0 0 0 0 0 0 0 0 0 700 701 701 702 0 0 0 0 0 0 0 0 0 0 0 0 0 0 0 0 
0 0 0 0 0 0 0 0 0 0 716 717 717 718 0 0 0 0 0 0 0 0 0 0 0 0 0 0 0 0 
0 0 0 0 0 0 0 0 0 0 0 0 0 0 0 0 0 0 0 0 0 0 0 0 0 0 0 0 0 0 
0 0 0 0 0 0 0 0 0 0 0 0 0 0 0 0 0 0 0 0 0 0 0 0 0 0 0 0 0 0 
0 0 0 0 0 0 0 0 0 0 0 0 0 0 0 0 0 0 0 0 0 0 0 0 0 0 0 0 0 0 
0 0 0 0 0 0 0 0 0 0 0 0 0 0 0 0 0 0 0 0 0 0 0 0 0 0 0 0 0 0 
0 0 0 0 0 0 0 0 0 0 0 0 0 0 0 0 0 0 0 0 0 0 0 0 0 0 0 0 0 0 
0 0 0 0 0 0 0 0 0 0 0 0 0 0 0 0 0 0 0 0 0 0 0 0 0 0 0 0 0 0 
0 0 0 0 0 0 0 0 0 0 0 0 0 0 0 0 0 0 0 0 0 0 0 0 0 0 0 0 0 0 
0 0 0 0 0 0 0 0 0 0 0 0 0 0 0 0 0 0 0 0 0 0 0 0 0 0 0 0 0 0 
0 0 0 0 0 0 0 0 0 0 0 0 0 0 0 0 0 0 0 0 0 0 0 0 0 0 0 0 0 0 
0 0 0 0 0 0 0 0 0 0 0 0 0 0 0 0 0 0 0 0 0 0 0 0 0 0 0 0 0 0 
0 0 0 0 0 0 0 0 0 0 0 0 0 0 0 0 0 0 0 0 0 0 0 0 0 0 0 0 0 0 
0 0 0 0 0 0 0 0 0 0 0 0 0 0 0 0 0 0 0 0 0 0 0 0 0 0 0 0 0 0 

sprites/castle.png
0 0 0 0 0 0 0 0 0 0 0 0 0 0 0 0 0 0 0 0 0 0 0 0 0 0 0 0 0 0 
0 0 0 0 0 0 0 0 0 0 0 0 0 0 0 0 0 0 0 0 0 0 0 0 0 0 0 0 0 0 
0 0 0 0 0 0 0 0 0 0 0 0 0 0 0 0 0 0 0 0 0 0 0 0 0 0 0 0 0 0 
421 0 0 0 0 0 0 0 0 0 0 0 0 0 0 0 0 0 0 0 0 0 0 0 0 0 0 0 0 0 
421 0 0 0 0 0 0 0 0 0 0 0 0 0 0 0 0 0 0 0 0 0 0 0 0 0 0 0 0 0 
421 0 0 0 0 0 0 0 0 0 0 729 0 0 0 0 729 0 0 0 0 782 0 0 833 834 0 0 782 0 
421 0 0 0 0 0 0 0 0 0 0 745 0 0 0 0 745 0 0 0 0 783 0 0 849 850 0 0 783 0 
421 0 0 0 0 0 0 753 754 0 0 0 0 0 0 0 531 532 0 0 650 0 0 0 699 699 699 699 0 0 
421 0 0 0 0 0 0 769 770 0 0 0 0 0 0 0 547 548 0 0 666 0 0 0 715 715 715 715 0 0 
421 0 0 0 0 0 0 785 786 0 0 0 0 0 0 0 0 0 0 0 0 0 0 0 715 715 715 715 0 0 
421 0 0 0 0 0 0 0 0 0 566 567 567 567 568 0 0 0 0 0 0 0 0 0 0 0 0 0 0 0 
421 0 0 0 0 0 0 0 0 0 582 583 585 583 584 0 0 0 0 0 0 0 0 0 644 0 645 0 0 0 
421 0 0 0 0 0 0 0 0 0 598 599 599 599 600 0 0 0 0 0 0 0 0 0 660 0 661 0 0 0 
421 0 0 0 0 0 0 0 0 0 0 0 0 0 0 0 0 0 0 424 0 0 0 0 0 0 0 0 0 0 
421 0 0 0 0 0 0 0 0 0 0 0 0 0 0 0 0 0 0 424 0 0 0 0 0 0 0 0 0 0 
421 0 0 0 0 0 0 0 0 0 0 763 0 0 0 0 0 0 0 424 0 0 0 0 0 0 0 0 0 0 
421 0 0 0 0 0 0 0 0 0 775 762 779 780 0 0 0 0 0 424 0 0 0 0 0 0 0 0 0 0 
421 0 0 0 0 0 0 0 0 0 0 0 0 0 0 0 0 0 0 424 0 0 0 0 0 0 0 0 0 0 
421 0 0 0 0 0 0 0 0 0 0 0 0 0 0 0 0 0 0 424 0 0 0 0 0 0 0 0 0 0 
421 0 0 0 0 0 0 0 0 0 0 0 0 0 0 0 0 0 0 424 0 0 0 0 0 0 0 0 0 0 
421 0 0 0 0 0 0 0 0 0 0 0 0 0 0 0 0 0 0 424 0 0 0 0 0 0 0 0 0 0 
421 0 0 0 0 0 0 0 0 0 0 0 0 0 0 0 0 0 0 424 0 0 0 0 0 0 0 0 0 0 
421 0 0 0 0 0 0 0 0 0 0 0 0 0 0 0 0 0 0 424 0 0 0 0 0 0 0 0 0 0 
502 420 420 420 420 420 420 420 420 420 420 420 420 420 420 420 420 420 420 456 420 420 420 420 420 420 420 420 420 420 
386 386 386 386 386 386 386 386 386 386 386 386 386 386 386 386 386 386 386 386 386 386 386 386 386 386 386 386 386 386 
386 386 386 386 386 386 386 386 386 386 386 386 386 386 386 386 386 386 386 386 386 386 386 386 386 386 386 386 386 386 
386 386 386 386 386 386 386 386 386 386 386 386 386 386 386 386 386 386 386 386 386 386 386 386 386 386 386 386 386 386 
0 0 0 0 0 0 0 0 0 0 0 0 0 0 0 0 0 0 0 0 0 0 0 0 0 0 0 0 0 0 
0 0 0 0 0 0 0 0 0 0 0 0 0 0 0 0 0 0 0 0 0 0 0 0 0 0 0 0 0 0 
0 0 0 0 0 0 0 0 0 0 0 0 0 0 0 0 0 0 0 0 0 0 0 0 0 0 0 0 0 0 

sprites/castle.png
0 0 0 0 0 0 0 0 0 0 0 0 0 0 0 0 0 0 0 0 0 0 0 0 0 0 0 0 0 0 
0 0 0 0 0 0 0 0 0 0 0 0 0 0 0 0 0 0 0 0 0 0 703 0 0 0 0 0 0 0 
0 0 0 0 0 0 721 721 721 721 721 721 721 722 721 721 721 721 721 721 723 674 0 720 703 0 0 0 0 0 
0 0 0 0 0 0 737 737 737 737 737 737 737 737 737 737 737 737 737 737 737 690 673 674 0 720 703 0 0 0 
0 0 0 0 0 0 724 724 724 724 724 724 724 724 724 724 724 724 724 724 724 706 689 690 673 674 0 720 0 0 
0 0 0 0 0 0 0 0 0 0 593 0 0 0 0 0 0 0 0 0 0 0 705 706 689 690 673 674 0 0 
0 0 0 0 0 0 483 0 0 0 609 0 0 0 0 0 574 575 0 0 0 0 0 0 705 706 689 690 727 485 
0 0 0 0 0 0 499 0 0 0 0 0 0 0 0 0 667 668 0 0 0 0 0 0 0 0 705 706 484 485 
0 0 0 0 0 0 515 0 0 0 0 0 0 0 0 0 651 652 0 0 0 0 0 0 699 699 699 699 500 501 
0 0 0 0 0 0 0 0 0 0 0 0 0 0 0 0 0 0 0 0 0 0 0 0 0 0 0 0 516 517 
0 0 0 0 0 0 0 0 0 0 0 0 0 0 0 0 0 0 0 0 0 0 0 0 0 0 0 0 0 0 
0 0 0 0 0 0 0 0 0 0 0 0 0 0 0 0 0 0 0 0 0 0 0 0 0 0 0 0 0 0 
0 0 0 0 0 0 0 0 0 0 0 0 0 0 0 0 0 0 0 0 0 0 0 0 0 0 0 0 0 0 
0 0 0 0 0 0 0 0 0 0 0 0 0 0 0 0 0 0 0 0 0 0 0 0 0 0 0 0 0 0 
0 0 0 0 0 0 0 0 0 0 0 0 0 0 0 0 0 744 740 741 0 0 0 0 0 0 0 0 0 0 
0 0 0 0 0 0 0 0 0 0 0 0 0 0 0 0 0 755 756 757 0 0 0 0 0 0 0 0 0 0 
0 0 0 0 0 0 0 0 0 0 0 0 0 0 0 0 789 0 772 0 0 0 0 0 0 0 0 0 0 0 
0 0 0 0 0 0 0 0 0 0 0 0 0 0 0 0 790 0 0 0 0 0 0 0 0 0 0 0 0 0 
0 0 0 0 0 0 0 0 0 0 0 0 0 0 0 0 790 0 0 0 0 0 0 0 0 0 0 0 0 0 
0 0 0 0 0 0 0 0 0 0 0 0 0 0 0 0 791 0 0 0 0 0 0 0 0 0 0 0 0 0 
0 0 0 0 0 0 0 0 0 0 0 0 0 0 0 0 0 0 0 0 0 0 0 0 0 0 0 0 0 0 
0 0 0 0 0 0 0 0 0 0 0 0 0 0 0 0 0 0 0 0 0 0 0 0 0 0 0 0 0 0 
0 0 0 0 0 0 0 0 0 0 0 0 0 0 0 0 0 0 0 0 0 0 0 0 0 0 0 0 0 0 
0 0 0 0 0 0 0 0 0 0 0 0 0 0 0 0 0 0 0 0 0 0 0 0 0 0 0 0 0 0 
0 0 0 0 0 0 0 0 0 0 0 0 0 0 0 0 0 0 0 0 0 0 0 0 0 0 0 0 0 0 
0 0 0 0 0 0 0 0 0 0 0 0 0 0 0 0 0 0 0 0 0 0 0 0 0 0 0 0 0 0 
0 0 0 0 0 0 0 0 0 0 0 0 0 0 0 0 0 0 0 0 0 0 0 0 0 0 0 0 0 0 
0 0 0 0 0 0 0 0 0 0 0 0 0 0 0 0 0 0 0 0 0 0 0 0 0 0 0 0 0 0 
0 0 0 0 0 0 0 0 0 0 0 0 0 0 0 0 0 0 0 0 0 0 0 0 0 0 0 0 0 0 
0 0 0 0 0 0 0 0 0 0 0 0 0 0 0 0 0 0 0 0 0 0 0 0 0 0 0 0 0 0 

