Clipping
01 01 01 01 01 01 01 01 01 01 01 00 00 01 01 01 01 01 
01 01 01 01 01 01 01 01 01 01 01 00 00 01 01 01 01 01 
01 01 01 01 01 01 01 01 01 01 01 00 00 01 01 01 01 01 
01 01 01 01 01 01 01 01 01 01 01 00 00 01 01 01 01 01 
01 1 00 00 00 00 0 1 01 01 01 00 00 00 00 1 1 01 
01 00 00 00 00 00 0 00 01 01 01 00 00 00 00 00 00 01 
01 00 00 00 00 00 00 0 01 01 01 00 00 00 00 00 00 01 
01 130 00 00 00 0 0 0 1 01 01 00 00 00 00 00 00 01 
01 00 00 00 00 00 00 00 00 00 00 00 00 00 00 00 00 01 
1 00 00 00 00 00 00 00 00 00 00 00 00 00 0 0 0 67 
1 00 00 00 00 00 00 00 0 0 0 00 00 00 0 0 0 67 
1 130 00 00 00 00 00 00 1 1 1 00 00 00 00 00 00 67 
1 00 00 00 00 00 00 00 1 1 1 00 00 00 00 00 00 67 
1 0 0 0 0 0 0 0 1 1 1 0 0 0 0 0 0 67 
1 1 1 1 1 1 1 1 1 1 1 0 0 67 67 67 67 67 

sprites/house_in_1.png
20 17 18 18 18 18 18 19 67 3 68 177 178 17 18 18 19 67 
20 33 34 20 20 34 34 35 67 3 68 193 194 33 34 34 35 67 
20 49 50 36 36 50 50 51 67 3 68 179 180 49 50 50 51 67 
20 49 50 0 0 50 50 51 83 66 84 195 196 49 50 50 51 67 
20 1 02 01 02 01 02 01 17 18 19 01 02 01 02 01 2 67 
20 02 01 02 01 02 01 02 33 34 35 02 01 02 01 2 1 67 
20 01 02 01 02 01 02 01 49 50 51 01 02 01 02 1 2 67 
20 02 01 02 01 02 01 02 49 50 51 02 01 02 01 2 1 67 
20 01 02 01 02 01 02 01 02 01 02 02 02 01 02 01 2 67 
20 02 01 02 01 02 01 02 01 02 01 02 01 02 1 2 1 67 
20 01 02 01 02 01 02 01 0 0 0 01 02 01 2 1 2 67 
20 02 01 02 01 02 01 02 19 3 20 02 01 02 01 02 1 67 
20 01 02 01 02 01 02 01 19 3 20 01 02 01 02 01 2 67 
26 0 0 0 0 0 0 0 25 3 20 1 2 81 65 65 65 97 
3 3 3 3 3 3 3 3 3 3 20 161 162 67 3 3 3 3 

sprites/house_third_1.png
0 0 0 1 2 0 0 0 0 0 0 00 00 0 0 0 0 0 
0 0 0 17 18 0 0 0 0 0 0 00 00 0 0 0 0 0 
0 0 0 33 34 0 3 4 0 0 0 00 00 0 67 68 0 0 
0 113 0 49 50 0 19 20 0 0 0 00 00 0 0 83 84 0 
0 129 00 00 00 00 35 36 0 0 0 00 00 00 00 99 100 0 
0 00 00 00 00 00 15 16 0 0 0 00 00 00 00 00 00 0 
0 114 00 00 00 00 00 00 0 0 0 00 00 00 00 00 00 0 
0 130 00 00 00 00 00 00 0 0 0 00 00 00 00 00 00 0 
0 00 00 00 00 00 00 00 00 00 00 00 00 00 00 00 00 0 
0 00 00 00 00 00 00 00 00 00 00 00 00 00 0 0 0 0 
0 114 00 00 00 00 00 00 0 0 0 00 00 00 0 0 0 0 
0 130 00 00 00 00 00 00 0 0 0 00 00 00 00 00 00 0 
0 00 00 00 00 00 00 00 0 0 0 00 00 00 00 00 00 0 
0 0 0 0 0 0 0 0 0 0 0 0 0 0 0 0 0 0 
0 0 0 0 0 0 0 0 0 0 0 0 0 0 0 0 0 0 

sprites/house_in_1.png
68 00 00 0 0 00 00 00 00 00 00 00 00 00 00 00 00 00 
68 00 00 0 0 00 0 0 00 0 0 00 00 00 00 00 00 00 
68 00 00 0 0 00 0 0 0 00 0 0 00 0 0 0 0 00 
68 0 00 0 0 00 0 0 00 0 00 00 00 0 0 0 0 00 
68 0 00 0 00 0 0 0 00 00 00 00 00 0 0 0 0 00 
68 00 00 00 00 0 0 0 00 00 00 00 00 00 00 00 00 00 
68 00 00 00 0 0 00 00 00 00 00 00 00 00 00 00 00 00 
68 00 00 00 0 0 00 00 00 00 00 00 00 00 00 00 00 00 
68 00 00 00 0 0 00 00 00 00 00 00 00 00 00 00 00 00 
68 00 00 00 0 0 00 00 00 00 00 00 00 00 0 0 0 0 
68 00 00 00 00 00 00 00 81 65 82 00 00 00 0 0 0 0 
68 00 00 00 00 00 00 00 67 0 68 00 00 00 00 00 00 0 
68 00 00 00 00 00 00 00 67 0 68 00 00 00 00 00 00 0 
98 65 65 65 65 65 65 65 97 0 68 0 0 21 0 0 0 0 
0 0 0 0 0 0 0 0 0 0 68 0 0 0 0 0 0 0 

sprites/house_in_1.png
00 00 00 00 00 00 00 00 00 00 00 00 00 00 00 00 00 00 
00 00 00 00 00 00 00 00 00 00 00 00 00 00 00 00 00 00 
00 00 00 00 00 00 00 00 00 00 00 00 00 00 00 00 00 00 
00 0 00 00 00 00 00 00 00 00 00 00 00 00 00 00 00 00 
00 0 00 00 00 00 00 00 00 00 00 00 00 00 00 00 00 00 
00 00 00 00 00 00 00 00 00 00 00 00 00 00 00 00 00 00 
00 00 00 00 00 00 00 00 00 00 00 00 00 00 00 00 00 00 
00 00 00 00 00 00 00 00 00 00 00 00 00 00 00 00 00 00 
00 00 00 00 00 00 00 00 00 00 00 00 00 00 00 00 00 00 
0 00 00 00 00 00 00 00 00 00 00 00 00 00 0 0 0 0 
0 00 00 00 00 00 00 00 81 65 82 00 00 00 0 0 0 0 
0 00 00 00 00 00 00 00 0 0 0 00 00 00 00 00 00 0 
0 00 00 00 00 00 00 00 0 0 0 00 00 00 00 00 00 0 
0 65 65 65 65 65 65 65 0 0 0 0 0 81 65 65 65 0 
0 0 0 0 0 0 0 0 0 0 0 0 0 0 0 0 0 0 

