Clipping
1 01 01 01 01 01 01 01 01 01 01 01 01 01 01 35 35 01 01 01 01 01 
1 01 01 01 01 01 01 01 01 01 01 01 01 01 01 35 35 01 01 01 01 01 
1 01 01 01 01 01 01 01 01 01 01 01 01 01 01 35 35 01 01 01 01 01 
1 01 01 01 01 01 01 01 01 01 01 01 01 01 01 35 35 01 01 01 01 01 
01 00 00 00 00 00 00 00 00 00 00 00 00 00 00 00 00 00 00 00 1 01 
01 00 00 00 00 00 00 00 00 00 00 00 00 00 00 00 00 00 00 00 00 01 
01 01 1 01 01 00 00 01 01 01 01 00 00 01 01 00 00 00 00 00 00 01 
01 01 1 01 01 00 00 01 01 01 01 00 00 01 01 00 00 00 00 00 00 01 
1 1 1 01 01 00 00 01 01 01 01 00 00 01 01 00 00 00 00 00 00 01 
01 01 01 01 01 00 00 01 01 01 01 00 00 01 01 00 00 00 0 0 35 01 
01 01 01 01 01 00 00 01 01 01 01 00 00 01 01 00 00 00 0 0 0 01 
01 0 0 0 00 00 00 0 0 01 01 00 00 01 01 00 00 00 00 00 00 01 
01 00 00 00 00 00 00 00 00 01 01 00 00 01 01 00 00 00 00 00 00 01 
01 00 00 00 00 00 00 00 00 01 01 00 00 01 01 00 00 00 00 00 00 01 
01 00 00 00 00 00 00 00 02 01 01 00 00 01 01 00 00 00 00 00 00 01 
01 0 0 0 0 0 0 0 0 01 01 00 00 01 26 0 0 0 0 0 0 01 

sprites/house_in_ground.png
68 17 18 18 18 18 18 18 18 18 18 18 18 18 18 18 18 18 18 18 19 67 
68 33 34 20 20 34 34 20 20 34 34 20 20 34 34 34 20 20 34 34 35 67 
68 49 50 36 36 50 50 36 36 50 50 36 36 50 50 50 36 36 50 50 51 67 
68 49 50 50 50 50 50 50 50 50 50 50 50 50 50 50 50 50 50 50 51 67 
68 01 02 01 02 01 02 01 02 01 02 01 02 01 02 01 02 01 02 01 02 67 
68 02 1 02 01 02 01 02 01 02 01 02 01 02 01 02 01 02 01 02 2 67 
100 100 1 23 24 01 02 00 00 00 00 01 02 00 00 01 02 01 02 01 02 67 
68 17 18 18 19 02 01 17 19 00 00 02 01 00 00 02 01 02 01 02 01 67 
68 33 34 34 35 01 02 33 35 00 00 01 02 00 00 02 02 01 02 01 02 67 
68 49 50 50 51 02 01 49 51 00 00 177 178 00 00 02 01 02 1 2 1 67 
68 49 50 50 51 01 02 49 51 00 00 193 194 00 00 01 02 01 2 1 2 67 
68 02 01 02 01 02 01 02 01 00 00 179 180 00 00 02 01 02 01 02 01 67 
68 01 02 01 161 145 162 01 02 00 00 195 196 00 00 01 02 01 02 01 02 67 
68 02 01 02 147 03 148 02 01 00 00 46 46 00 00 2 1 2 1 2 1 67 
68 01 02 01 163 146 164 01 02 00 00 46 46 00 00 2 02 2 02 2 02 67 
68 65 65 65 65 65 01 02 01 00 00 46 46 00 26 17 17 17 17 17 17 67 

sprites/house_third_1.png
00 00 0 1 2 00 00 01 02 00 00 01 02 00 00 00 1 2 00 00 00 00 
00 00 0 17 18 00 00 17 18 00 00 17 18 00 00 0 17 18 00 00 00 00 
00 00 0 33 34 00 00 33 34 00 00 33 34 0 0 0 33 34 00 00 00 00 
00 00 0 49 50 00 00 49 50 00 00 49 50 00 00 00 49 50 00 83 84 00 
00 00 00 00 00 00 00 00 00 00 00 00 00 00 00 00 00 0 00 99 100 00 
00 00 00 00 00 00 00 00 00 00 00 00 00 00 00 00 00 00 00 0 0 00 
00 00 00 00 00 00 00 00 00 00 00 00 00 00 00 00 00 00 00 00 00 00 
00 00 00 00 00 00 00 00 00 00 00 00 00 00 00 00 00 00 00 00 00 00 
00 00 00 00 00 00 00 00 00 00 00 00 00 00 00 00 00 00 00 00 31 00 
00 26 26 00 00 00 00 00 00 00 00 00 00 00 00 00 00 00 0 0 35 00 
00 21 22 116 00 00 00 23 24 00 00 00 00 00 00 00 00 00 0 0 0 00 
00 25 26 132 00 00 00 27 28 00 00 00 00 00 00 00 00 00 00 00 00 00 
00 00 00 00 00 00 00 00 00 00 00 00 00 00 00 00 00 00 00 00 00 00 
00 37 38 00 00 00 00 00 115 00 00 00 00 00 00 00 00 00 00 00 00 00 
00 41 42 00 00 00 00 00 131 00 00 00 00 00 00 00 00 00 00 00 00 00 
00 00 00 00 00 00 00 00 00 00 00 00 00 00 0 00 00 00 00 00 00 00 

sprites/house_in_wall.png
00 00 00 00 00 00 00 00 00 00 00 00 00 00 00 00 00 00 00 00 00 00 
00 00 00 00 00 00 00 00 00 00 00 00 00 00 00 00 00 00 00 00 00 00 
00 00 00 00 00 00 00 00 00 00 00 00 00 00 00 00 00 00 00 00 00 00 
00 00 00 00 00 00 00 00 00 00 00 00 00 00 00 00 00 00 00 00 00 00 
00 00 00 00 00 00 00 00 00 00 00 00 00 00 00 00 00 00 00 00 00 00 
26 17 17 17 22 00 0 81 65 65 22 00 00 21 22 00 00 00 00 00 00 00 
28 18 18 18 00 00 00 23 18 27 20 00 00 19 20 00 00 00 00 00 00 00 
00 00 00 6 00 00 00 5 7 19 20 00 00 19 20 00 00 00 00 00 00 00 
00 00 00 00 00 00 00 9 11 19 20 00 00 19 20 00 00 00 00 00 00 00 
00 00 00 00 00 00 00 13 15 19 20 00 00 19 20 00 00 00 00 00 00 00 
00 00 00 00 00 00 00 0 0 19 20 00 00 19 20 00 00 00 00 00 00 00 
00 00 00 00 00 00 00 00 00 19 20 00 00 19 20 00 00 00 00 00 00 00 
00 00 00 00 00 00 00 00 00 19 20 00 00 19 20 00 00 00 00 00 00 00 
00 00 00 00 00 00 00 00 00 19 20 00 00 19 20 00 00 00 00 00 00 00 
00 00 00 00 00 00 00 00 00 19 20 00 00 19 20 00 00 00 00 00 00 00 
26 17 17 17 17 17 17 17 17 25 20 00 00 19 0 00 00 00 00 00 00 00 

sprites/house_in_wall.png
00 00 00 00 00 00 00 00 00 00 00 00 00 00 00 00 00 00 00 00 00 00 
00 00 00 00 00 00 00 00 00 00 00 00 00 00 00 00 00 00 00 00 00 00 
00 00 00 00 00 00 00 00 00 00 00 00 00 00 00 00 00 00 00 00 00 00 
00 00 00 00 00 00 00 00 00 00 00 00 00 00 00 00 00 00 00 00 00 00 
00 00 00 00 00 00 00 00 00 00 00 00 00 00 00 00 00 00 00 00 00 00 
98 65 65 65 82 00 00 00 00 00 82 00 00 81 82 00 00 00 00 00 00 00 
100 66 66 66 84 00 00 83 66 99 68 00 00 67 68 00 00 00 00 00 00 00 
68 0 0 0 0 00 00 0 0 67 68 00 00 67 68 00 00 00 00 00 00 00 
68 0 0 0 0 00 00 0 0 67 68 00 00 67 68 00 00 00 00 00 00 00 
68 0 0 0 0 00 00 0 0 67 68 00 00 67 68 00 00 00 00 00 00 00 
68 0 0 0 0 00 00 0 0 67 68 00 00 67 68 00 00 00 00 00 00 00 
68 00 00 00 00 00 00 0 0 67 68 00 00 67 68 00 00 00 00 00 00 00 
00 00 00 00 00 00 00 00 00 67 68 00 00 67 68 00 00 00 00 00 00 00 
00 00 00 00 00 00 00 00 00 67 68 00 00 67 68 00 00 00 00 00 00 00 
00 00 00 00 00 00 00 00 00 67 68 00 00 67 68 00 00 0 0 0 0 00 
98 65 65 65 65 65 65 65 65 67 68 00 00 67 98 65 65 65 65 65 65 97 

